Check in / out : làm thủ tục ra / vào
account for: chiếm, giải thích
allow for: tính đến, xem xét đến
ask after: hỏi thăm sức khỏe
ask for: hỏi xin ai cái gì
ask sb in/ out : cho ai vào/ ra
urge sb into/ out of : thuyết phục ai làm gì/không làm gì
be over: qua rồi
be up to sb to V: ai đó có trách nhiêm phải làm gì
bear up: to confirm : xác nhận
bear out: chịu đựng
blow out : thổi tắt
blow down: thổi đổ
blow over: thổi qua
break away: to run away :chạy trốn
break down : hỏng hóc, suy nhược, òa khóc
break in : đột nhập, cắt ngang
break up: chia tay , giải tán
break off: tan vỡ một mối quan hệ
bring about: mang đến, mang lại
brinn down : to land : hạ xuống
bring out : xuất bản
bring up : nuôi dưỡng ( danh từ là up bringing)
bring off : thành công, ẵm giải
burn away : tắt dần
burn out: cháy trụi
call for: mời gọi, yêu cầu
call up: gọi đi lính, gọi điện thoại, nhắc lại kỉ niệm
call on/ call in at sb's house : ghé thăm nhà ai
call off : put off : cancel
advance in : tấn tới
advance on : trình bày
advance to : tiến đến
agree on something : đồng ý với điều gì
agree with : đồng ý với ai, hợp với, tốt cho
answer to : hợp với
answer for : chịu trách nhiệm về
attend on / upon: hầu hạ
attend to : chú ý
back up : ủng hộ, nâng đỡ
bear on : có ảnh hưởng, liên lạc tới
become of : xảy ra cho
begin with : bắt đầu bằng
begin at : khởi sự từ
believe in : tin cẩn, tin có
belong to : thuộc về
bet on : đánh cuộc vào
care for :thích, săn sóc
catch up with : bắt kịp
chance upon : tình cờ gặp
close with : tới gần
close about : vây lấy
come to : lên tới
consign to : giao phó cho
cry for :khóc đòi
cry for something : kêu đói
cry for the moon : đòi cái ko thể
cry with joy :khóc vì vui
cut something into : cắt vật gì thành
cut into : nói vào, xen vào
delight in :thích thú về
depart from : bỏ, sửa đổi
do with : chịu đựng
do for a thing : kiếm ra một vật
Call in/on at sb ‘ house : ghé thăm nhà ai i
Call at : ghé thăm
Call up: gọi đi lính, gọi điện thoại, nhắc lại kỉ niệm
Call off : put off :cacel : huỷ bỏ
Call for : yêu cầu, mời gọi
Care about: quan tâm, để ý tới
Care for :  quan tâm chăm sóc ~ take care of
Carry away : mang đi , phân phát
Carry on : go on : tiếp tục
Carry out :tiến hành , thực hiện
Carry off : bring off : ẵm giải
Catch on : trở nên phổ biến , nắm bắt kịp
Catch up with : keep up with : keep pace with : theo kịp ai , cái gì
Chew over : think over : nghĩ kĩ
Check up : kiểm tra sức khoẻ
Clean out : dọn sạch , lấy đi hết
Clean up : dọn gọn gàng
Clear away : , lấy đi , mang đi
Clear up : làm sáng tỏ
Close down : phá sản , đóng cửa nhà máy
Close in : tiến tới
Close up: xích lại gần nhau
Come over/ round : visit
Come round : hồi tỉnh
Come down: sụp đổ  , giảm
Come down to : là do
Come up : đề cập đến , nhô lên , nhú lên
Come up with : nảy ra, loé lên
Come up against : đương đầu, đối mặt
Come out : xuất bản
Come out with : tung ra sản phẩm
Come about : happen
Come across : tình cờ gặp
Come apart : vỡ vụn , lìa ra
Come along / on with : hoà hợp , tiến triển
Come into : thừa kế
Come off : thành công, long ,bong ra
Count on SB for ST : trông cậy vào ai
Cut back on / cut down on : cắt giảm ( chi tiêu)
Cut in : cắt ngang
Cut ST out off ST : cắt cái gì rời khỏi cái gì
Cut off :cô lập , cách li , ngừng phục vụ
Cut up : chia nhỏ
Cross out : gạch đi, xoá đi
Die away / die down : giảm đi , dịu đi ( về cường độ )
Die out / die off: tuyệt chủng
Die for : thèm gì đến chết
Die of : chết vì bệnh gì
Do away with : bãi bỏ, bãi miễn
Do up : decorate
Do with : làm đc gì nhờ có
Do without : làm đc gì mà không cần
Draw back : rút lui
Drive at : ngụ ý, ám chỉ
Drop in at SB ‘s house: ghé thăm nhà ai
Drop off : buồn ngủ
Drop out of school : bỏ học
End up : kết thúc
Eat up : ăn hết
Eat out : ăn ngoài
Face up to : đương đầu , đối mặt
Fall back on : trông cậy , dựa vào
Fall in with: mê cái gì
Fall behind : chậm hơn so với dự định , rớt lại phía sau
Fall through : : put off, cancel
Fall off : giảm dần
Fall down : thất bại
Fell up to : cảm thấy đủ sức làm gì
Fill in : điền vào
Fill up with : đổ đầy
Fill out : điền hết , điền sạch
Fill in for : đại diện, thay thế
Find out : tìm ra
Get through to sb : liên lạc với ai
Get through / over : hoàn tất , vượt qua
Get into : đi vào , lên ( xe)
Get in: đến , trúng cử
Get off : cởi bỏ , xuống xe , khởi hành
Get out of : avoid
Get down : đi xuống, ghi lại
Get sb down : làm ai thất vọng
Get down to doing : bắt đầu nghiêm túc làm vịêc gì
Get to doing : bắt tay vào làm việc gì
Get round...( to doing) : xoay xở , hoàn tất
Get along / on with : come along / on with
Get st across : làm cho cái gì đc hiểu
Get at : drive at
Get back : trở lại
Get up : ngủ dậy
Get ahead : vượt trước ai
Get away with : cuỗm theo cái gì
Get over : vượt qu a
Get on one’s nerves:làm ai phát điên , chọc tức ai
Give away : cho đi , tống đi , tiết lộ bí mật
Give st back : trả lại
Give in : bỏ cuộc
Give way to : nhượng bộ , đầu hàng, nhường chỗ cho ai
Give up : từ bỏ
Give out : phân phát , cạn kịêt
Give off : toả ra , phát ra ( mùi hương , hương vị)
Go out : đi ra ngoài , lỗi thời
Go out with : hẹn hò
Go through : kiểm tra , thực hiện công việc
Go through with : kiên trì bền bỉ
Go for : cố gắng giành đc
Go in for : : take part in
Go with : phù hợp
Go without : kiêng nhịn
Go off : nổi giận, nổ tung , thối giữa ( thức ăn )
Go off with : give away with : cuỗm theo
Go ahead : tiến lên
Go back on one ‘ s word : không giữ lời
Go down with : mắc bệnh
Go over: kiểm tra , xem xét kĩ lưỡng
Go up : tăng , đi lên , vào đại học
Go into : lâm vào
Go away : cút đi , đi khỏi
Go round : đủ chia
Go on : tiếp tục
Grow out of : lớn vượt khỏi
Grow up: trưởng thành
Hand down to : pass on to : truyền lại ( cho thế hệ sau,,,,)
Hand in : giao nộp ( bài , tội phạm )
Hand back : giao lại
Hand over: trao trả quyền lực
Hand out : phân phát
Hang round : lảng vảng
Hang on : hold on : hold off : cầm máy (điện thoại
Hang up ( off) : cúp máy
Hang out : treo ra ngoài
Hold on off : put off
Hold on: cầm máy
Hold back : kiềm chế
Hold up : cản trở / trấn lột
Jump at a chance /an opportunity : chộp lấy cơ hội
Jump at a conclusion : vội kết luận
Jump at an order : vội vàng nhận lời
Jump for joy : nhảy lên vì sung sướng
Jump into ( out of) : nhảy vào ( ra)
Keep away from : keep off : tránh xa
Keep out of : ngăn cản
Keep sb back from : ngăn cản ai không làm gì
Keep sb from : stop sb from
Keep sb together : gắn bó
Keep up : giữ lại , duy trì
Keep up with : theo kip ai
Keep on : keep ving : cứ tiếp tục làm gì
Knock down : pull down : kéo đổ , sụp đổ, san bằng
Knock out : hạ gục ai
Lay down : ban hành , hạ vũ khí
Lay out : sắp xếp, lập dàn ý
Leave sb off : to dismiss sb: cho ai nghỉ việc
Leave out : get rid of
Let sb down : làm ai thất vọng
Let sb in / out : cho ai vào / ra , phóng thích ai
Let sb off : tha bổng cho ai
Lie down : nằm nghỉ
Live up to: sống xứng đáng với
Live on : sống dựa vào
Lock up: khóa chặt ai
Look after : chăm sóc
Look at : quan sát
Look back on: nhớ lại hồi tưởng
Look round : quay lại nhìn
Look for: tìm kiếm
Look forward to ving: mong đợi , mong chờ
Look in on : ghé thăm
Look up : tra cúư ( từ điển, số điện thoại )
Look into : xem xét , nghiên cứu
Look on : đứng nhìn thờ ơ
Look out : coi chừng
Look out for : cảnh giác với
Look over : kiểm tra
Look up to : tôn trọng
Look dowm on : coi thường
Make up : trang điểm, bịa chuyện
Make out : phân biệt
Make up for : đền bù, hoà giải với ai
Make the way to : tìm đường đến
Mix out :trộn lẫn , lộn xộn
Miss out : bỏ lỡ
Move away: bỏ đi, ra đi
Move out : chuyển đi
Move in: chuyển đến
Order SB about ST: sai ai làm gì
Owe st to sb : có đc gì nhờ ai
Pass away : to die
Pass by : go past : đi ngang qua , trôi qua
Pass on to : hand down to : truyền lại
Pass out : to faint : ngất
Pay sb back : trả nợ ai
Pay up the dept : trả hết nợ nần
Point out : chỉ ra
Pull back : rút lui
Pull down : to knock down : kéo đổ , san bằng
Pull in to :vào( nhà ga )
Pull st out : lấy cái gì ra
Pull over at : đỗ xe
Put st aside : cất đi , để dành
Put st away : cất đi
Put through to sb : liên lạc với ai
Put down : hạ xuống
Put down to : lí do của
Put on : mặc vào : tăng cân
Put up : dựng lên , tăng giá
Put up with : tha thứ, chịu đựng
Put up for : xin ai ngủ nhờ
Put out : dập tắt
Put st/ sb out : đưa ai / cái gì ra ngoài
Put off : trì hoãn
Run after : truy đuổi
Run away/ off from : chạy trốn
Run out (of) : cạn kiệt
Run over : đè chết
Run back : quay trở lại
Run down : cắt giảm , ngừng phục vụ
Run into : tình cờ gặp , đâm xô , lâm vào
Ring after : gọi lại sau
Ring off : tắt máy ( điện thoại )
Save up : để giành
See about : see to : quan tâm , để ý
See sb off : tạm biệt
See sb though : nhận ra bản chất của ai
See over : go over
Send for: yêu cầu , mời gọi
Send to :đưa ai vào ( bệnh viện , nhà tù
Send back : trả lại
Set out / off : khởi hành , bắt đầu
Set in: bắt đầu ( dùng cho thời tiết)
Set up :dựng lên
Set sb back: ngăn cản ai
Settle down : an cư lập nghiệp
Show off: khoe khoang , khoác lác
Show up :đến tới
Shop round : mua bán loanh quanh
Shut down : sập tiệm , phá sản
Shut up : ngậm miệng lại
Sit round : ngồi nhàn rỗi
Sit up for : chờ ai cho tới tận khuya
Slown down : chậm lại
Stand by: ủng hộ ai
Stand out : nổi bật
Stand for : đại diện, viết tắt của, khoan dung
Stand in for : thế chỗ của ai
Stay away from : tránh xa
Stay behind: ở lại
Stay up :đi ngủ muộn
Stay on at: ở lại trường để học thêm
Take away from : lấy đi, làm nguôi đi
Take after : giống ai như đúc
Take sb / st back to : đem trả laị
Take down : lấy xuống
Mistake sb for sb else : nhầm ai với ai
Take in : lừa gạt ai , hiểu
Take on : tuyển thêm , lấy thêm người
Take off : cất cánh , cởi tháo bỏ cái gì
Take over : giành quyền kiểm soát
Take up : đảm nhận, chiếm giữ ( không gian ), bắt đầu làm gì ( thành thú tiêu khiển)
Take to : yêu thích
Talk sb into st : thuyết phục ai
Talk sb out of : cản trở ai
Throw away : ném đi , vứt hẳn đi
Throw out: vứt đi, tống cổ ai
Tie down : ràng buộc
Tie in with : buộc chặt
Tie sb out : wear sb out : exhaust sb
Tell off : mắng mỏ
Try on: thử ( quần áo )
Try out : thử...( máy móc )
Turn away: turn down : :từ chối
Turn into : chuyển thành
Turn out: sx , hoá ra là
Turn on / off: mở, tắt
Turn up / down : vặn to , nhỏ ( âm lượng )
Turn up: xuất hịên , đến tới
Turn in: đi ngủ
Use up : sử dụng hết ,cạn kiệt
Wait for : đợi
Wait up for: đợi ai đến tận khuya
Watch out /over: look out
Watch out for : look out for
Wear off : mất tác dụng , biến mất , nhạt dần
Wear sb out : exhaust sb
Work off : loại bỏ
Work out: tìm ra cách giải quyết
Work up : làm khuấy động
Wipe out : huỷ diệt / exhaust sb
Write down : viết vào
hear of: nghe nói tới
make a success of sth: thành công về việc gì
be relate to: có bà con với ai
give advice on:
be apposed to: phản đối, chống lại
write with a pen: viết bằng bút
belong to: của thuộc về ai
succeed in: thành công
happen to : xảy ra với
aim at: nhắm vào
care for: chăm sóc
complain of sth: phàn nàn về điều gì
turn one’s back on someone: bỏ rơi ai
jump over sth: nhảy qua cái gì
fall over sth: vấp phải vất gì
be wounded in the leg: bị thương ở chân
speak in a whisper: nói nhỏ
be released from prison: ra tù
know someone from someone: pha biệt được ai với ai
be expect in…: chuyên môn về….
rejoice at:mừng rỡ về điều gì
Catch sight of :bắt gặp
Lose sight of :mất hút
Make fun of :chế diễu
Lose track of :mất dấu
Take account of :lưu tâm
Take note of :để ý
Take care of :chăm sóc
Take advantage of :lợi dụng
Take leave of :từ biệt
Give birth to : sanh con
Give place to :nhường chỗ
Give way to :nhượng bộ, chịu thua
Pay attention to :chú ý
Put an end to :kết thúc
Put a stop to :chấm dứt
Set fire to :đốt cháy
Make a contribution to : góp phần
Lose touch with :mất liên lạc
Keep pace with :theo kịp
Keep correspondence with :liên lạc thư từ
Make room for : dọn chỗ
Make allowance for :chiếu cố
Show affection for :có cảm tình
Feel pity for :thương xót
Feel regret for :ân hận
Feel sympathy for :thông cảm
Take/have pity on :thương xót
Make a decision on :quyết định
Make complaint about :kêu ca, phàn nàn
Make a fuss about :làm om xòm
Play an influence over :có ảnh hưởng
Get victory over :chiến thắng
Take interest in :quan tâm
Have faith in :tin tưởng
Feel shame at : xấu hổ
Have a look at : nhìn
choose s.o for (a post) : chọn ai vào một chức vụ gì
make a fool of s.o : làm cho ai trở thành ngu ngốc
make a singer of s.o : làm cho ai trở thành ca sĩ
make the best of s.th : tận dụng tối đa điều gì
send for s.o : gửi ai đến, gửi ai tới
send s.o s.th : gửi cho ai cái gì
send s.th to s.o : gửi cái gì cho ai
set on fire : gây hỏa hoạn
A true friend to s.o : một người bạn tốt đối với ai
give s.o a ring : gọi dây nối, điện thoại
had better : tốt hơn (thường dùng ở dạng rút gọn
in connection with : liên kết với, kết hợp với
in time : kịp giờ
It comes to doing s.th: tới lúc làm việc gì
It is kind of you : bạn thật tử tế
It is thoughtful of you : bạn thật cẩn thận, chu đáo
little by little : dần dần từng chút từng chút một, từ từ
never mind : đừng lưu tâm đến, đưng lưu ý đến, khỏi lo
no good to s.o : không tốt cho ai
on time : đúng giờ
stick out : nhô ra, lộ ra, lòi ra.
be of royal blood : thuộc dòng dõi quý tộc
be out of the question : ngoài vấn đề, không thành vấn đề, không thể
feel like + V ing : muốn (làm gì)
take out : lấy ra, rút ra
a place : đến một nơi nào
accuse s.o of s.th : tố cáo ai về tội gì
adapt oneself to (a situation) : thích nghi vào một hoàn cảnh
add s.th to another : thêm một vật vào một vật khác
adhere to : đính vào, bám vào
agree with s.o : đồng ý với ai
aim at : nhắm vào
argue with s.o about s.th : tranh cãi với ai về điều gì
arrange for : sắp xếp cho
arrive in : đến (một thành phố hay một đất nước)
ask for : đòi hỏi, yêu cầu
attend to : chú ý đến
be satisfied with : thỏa mãn với, hài lòng với
be above s.o in the examination list : thi đậu cao hơn ai
be accustomed to : quen với
be accustomed to doing s.th : quen làm việc gì
be acquainted with s.o : quen biết ai
be afraid of : sợ
be against s.o : chống lại ai
be anxious about s.th : nôn nóng, lo lắng về điều gì
be appropriate for : thích hợp cho
be astonished at s.th : kinh ngạc về điều gì
be available to : có sẵn, sẵn sàng
be aware of : biết, nhận biết
be bad at ( a subject) : dở về môn gì
be beneficent to s.o : từ thiện đối với ai
be beside the point : ngoài đề, lạc đề
be brought before the judge : bị đưa ra tòa
be capable of doing s.th : có khả năng làm việc gì
be conscious of : ý thức về
be considerate of : ân cần, chú ý tới
be contempt for s.o : khinh miệt ai
be content with : hài lòng với
be contrary to : tương phản, trái ngược với ai
be courteous to s.o : lịch sự đối với ai
be critical of : hay phê bình, hay chỉ trích về
be destined for: được dành riêng (để làm điều gì)
be different from : khác với
be dressed in white : mặc đồ trắng, mặc quần áo trắng
be eligible for : đủ điều kiện, đủ tiêu chuẩn
be engaged in doing s.th : bận bịu về điều gì
be engaged to s.o : đính hôn với ai
be enthusiastic about : hăng hái, say mê
be equal to : ngang, bằng
be essential for : cần thiết cho
be experienced in s.th : có kinh nghiệm về việc gì
be expert in (a subject) : chuyên môn về cái gì
be expressive of : diễn đạt, biểu lộ
be faithful to : trung thành với
be false to s.o : giả dối đối với ai
be familiar to : rành rẽ, quen thuộc
be familiar with s.o : thân mật , là tình nhân của ai
be famous for : nổi tiếng về
be fatal to s.o : nguy hiểm đến tính mạng ai
be favourable for doing s.th : thuận lợi để làm gì
be filled with tears : đầy nước mắt
be forgetful of s.th : hay quên về
be free from : thoát khỏi.
be full of : đầy, tràn ngập
be gallant to ladies : lịch sự với phụ nữ, nịnh đầm
be good at (subject) : giỏi về môn gì
be good for one's health : tốt cho sức khỏe của ai
be guilty of : có tội
be happy about : vui vẻ vì, hạnh phúc vì
be hopeful of : hi vọng về
be hungry for s.th : thèm khát điều gì
be identical to : giống, giống nhau
be ignorant of s.th : không biết điều gì
be important to s.o : quan trọng đối với ai
be in : đang thịnh hành, đang là mốt
be in bad temper : cáu kỉnh
be in business : đi làm ăn
be in danger : nguy hiểm
be in debt : mắc nợ
be in favor of : ủng hộ tán thành
be in fond of : thích
be in for a storm : gặp bão
be in port : vào cảng
be in sight : trông thấy, trong tầm mắt có thể nhìn thấy
be in want of money : thiếu tiền
be indebted to s.o : mang ơn ai, mắc nợ ai
be independent of : độc lập với, không lệ thuộc vào
be indifferent to : thơ ờ, lãnh đạm, không quan tâm đến
be indifferent to : thờ ơ, xao lãng
be innocent of : vô tội
be intended for s.o : dành cho ai
be interested in : quan tâm tới
be involve in : có liên quan, dính líu tới
be jealous of : ganh tỵ về
be kind to s.o : tử tế với ai
be looking forward to s.t : to look forward to s.t : mong mỏi
be loyal to s.o : trung thành với ai
be mad about : đam mê, say mê
be made from : làm từ (vật được làm ra không còn giữ nguyên chất liệu ban đầu)
be made of : làm bằng (vật được làm ra còn giữ chất liệu ban đầu)
be named after : được đặt tên theo (tên một người khác)
be negligent of : xao lãng
be new to s.o : mới lạ đối với ai
be offended at (by) s.th : giận dữ, bực mình về việc gì
be offended with (by) s.o : bị xúc phạm bởi ai, giận ai
be on fire : đang cháy
be on holiday : đi nghỉ lễ
be on the committee : là thành viên ủy ban
be opposed to : phản đối, chống lại
be out of order : hư, không hoạt động
be over : xong kết thúc chấm dứt
be patient with s.o : kiên nhẫn đối với ai
be perfect for doing s.th : tuyệt hảo để làm việc gì
be pleasing to s.o : làm vừa ý ai, làm ai dễ chịu
be popular with: phổ thông đối với ai
be positive about s.th : quả quyết về điều gì.
be preferable to : thích hơn
be prepared for : sẵn sàng, chuẩn bị
be proud of : hãnh diện về
be put in prison : bị tống giam
be qualified for doing s.th : đủ tiêu chuẩn, đủ trình độ để làm việc gì
be ready for : sẵn sàng
be related to : có bà con thân thuộc với
be responsible for : chịu trách nhiệm về
be satisfactory to s.o : thỏa mãn đối với ai, làm ai hài lòng.
be sawn into small logs : cưa thành những khúc nhỏ
be secured from ( a disaster) : an toàn , ko bị tai nạn
be shocked at s.th : xúc động về điều gì
be stolen from : bị trộm
be stuck get stuck : bị lừa gạt
be suitable for : thích hợp với.
be superior to : vượt hơn
be sure of :chắc chắn
be tired from : mệt nhọc vì
be tired of : chán ngấy vì
be tired out : mệt lử, mệt lả người
be to one's liking : hợp với sở thích của ai
be to one's taste : hợp với khẩu vị của ai
be tolerant of : nhân nhượng, nhượng bộ
be under age : dưới tuổi thành niên
be under repair : đang được sửa chữa
be unfit for : không thích hợp với
be up : hết xong (dùng cho thời gian)
be up to s.o : tùy thuộc vào sự quyết định của ai, tùy vào ai
be used to doing s.th : quen làm việc gì
be useful for : hữu ích
be welcome to : được đón tiếp, được chào đón
be welloff : giàu ( to be rich)
be wounded in the leg : bị thương ở chân
become of : ra sao, xảy ra, xảy đến (cho người hay vật bị thiếu vắng)
believe in : tin tưởng vào
believe in : tin, tin tưởng
belong to : thuộc về, của
bite off : cắt đứt ra
blow away : thổi bay đi
blow down : thổi ngã rạp xuống
blow off : cuốn bay đi
blow up : nổ tung, làm cho nổ
boast about s.th to s.o : khoe khoang, khoac lác với ai về điều gì
break away : vượt khỏi, thoát
break down : hỏng, không chạy được (máy móc, xe cộ)
break down : phá sập xuống
break off : bẻ gãy, đâp vỡ
break out : xảy ra thình lình, bộc phát
break through : phá thủng, vỡ
break up : bẻ nhỏ, vụn ra
bring to : tỉnh , hồi tỉnh
bring up : dạy dỗ, nuôi cho trưởng thành
burden ( an animal) with s.th : chất cái gì lên một con vật
burn down : bị thiêu hủy, cháy rụi
burn out : đứt (bóng đèn, cầu chì), không còn dùng được
burn up : cháy rụi hết, cháy ra tro
burn up : đốt hết, cháy hết, cháy tiêu
burst into tear : bật khóc
burst out crying : phát khóc, bật khóc, òa lên khóc
burst out laughing : phát cười, bật cười, phá cười lên
call down : rày la, khiển trách, trách mắng
call off : bãi bỏ, hủy bỏ,bác bỏ thủ tiêu
call on : viếng thăm
call s.o's attention to s.th : lưu ý ai về điều gì
care about : quan tâm tới
care for : chăm sóc, chú ý tới, thích
carry out : hoàn thành, thực hiện, thi hành
catch cold : bị cảm lạnh
catch fire : bắt lửa, phát cháy
check on : kiểm soát,
check up : khám xét
check up on : kiểm tra, xem xét
check up on : phối kiểm.
chew up : nhai nhỏ ra, gặm nát
chop up : chặt nhỏ ra, bẻ vụn ra
clean up : lau sạch
clear up : khích lệ, làm cho vui, phấn khởi
come about :xảy ra
come across : chợt thấy , ngẫu nhiên thấy, gặp (bất ngờ)
come across : tình cờ, tình cờ tìm ra, nhân thấy, trông thấy
come to : hồi tỉnh, hồi sinh, tỉnh lại
compare with : so sánh với
complain of s.th : kêu ca, phàn nàn về chuyện gì
condemn s.o for doing s.th : kết án ai về điều gì
condemn s.o to death : kết án tử hình ai
congratulate s.o on s.th : khen ngợi, chúc mừng ai về điều gì
consent to a proposal : tán thành một lời đề nghị
count on : hi vọng ở, trông mong ở
count on : tin cậy vào
cross out : xóa bỏ, gạch bỏ
cure s.o of an illness : chữa khỏi bệnh cho ai
cut off : cắt lìa ra, cắt bỏ
cut up : cắt nhỏ, vụn ra
decide upon s.th : quyết định chọn điều gì
depend on s.o : lệ thuộc vào ai
deprive s.o of s.th : tước đi cái gì của ai
die away : lắng dịu, dần tắt, im bặt, tan biến ở xa (dùng cho âm thanh).
die down : giảm bớt, hạ nhiệt, suy giảm.
die of : chết vì
die out : dần dần biến mất hẳn
do over : lặp lại, làm lại
do s.th under orders : làm điều gì theo mệnh lệnh
draw up : thảo, soạn (văn kiện)
dream of : mơ tới, mơ về
dress up : trang điểm, chải chuốt
drink to s.th : uống mừng về điều gì
drink up : uống hết
drive up to : lại tới
drop in on : ghé thăm, rẽ vào thăm, ghé chơi
drop in on s.o : ghé vào thăm ai, tạt vào thăm ai
drop out : thôi, bỏ, rút (chân) ra khỏi
drop s.o a line : viết cho ai vài dòng, viết vài hàng
ear one's living by doing s.th : làm gì đó để kiếm sống
eat up : ăn hết
excuse s.o for doing s.th : tha thứ cho ai vì làm điều gì
exempt s.o from doing s.th : miễn cho ai khỏi làm việc gì
fail in an examination : thi rớt
fall down the stairs : ngã cầu thang
fall off : rơi, rớt xuốnggiảm, sa sút
fall onto s.th : rơi lên trên vật gì, ngã đè lên trên vật gì
fall over s.th : vấp phải vật gì mà ngã
fall through : thất bại, hỏng.
fasten one's eyes on : nhìn chằm chằm vào
feel like + gerund ( v + ing) : thích cái gì
feel sorry for : thương hại, thương cảm
feel up to s.th : cảm thấy khỏe khoắn, thích hợp với việc gì
fill in : điền vào, ghi vào điền vào, ghi vào cho đầy đủ, bổ túc cho đầy đủ (đơn từ)
fill out : mở rộng ra, làm rộng ra
fill up : đổ đầy xăng (cho xe…)
find fault with : phê bình, chỉ trích
find fault with s.th : chỉ trích điều gì
find out : tìm ra, tìm được, khám phá, tìm thấy
fix for : ấn định thời gian cho
force one's way through : chèn lối đi qua
forget s.o for s.th : quên ai về chuyện gì
get + (sick, well, tired, wet, busy.....) : bị ốm, thấy khá, mệt, ẩm ướt, bận rộn…
get along : tiến bộ, thành tựu, chạy (nói về công việc)
get along with s.o: hòa thuận với ai
get away : trốn thoát, lìa bỏ
get away with : thoát khỏi sự trừng phạt, hình phạt tội
get away with s.th : tránh khỏi bị khiển trách vì điều gì
get back : trở lại, trở về
get better (worse) : trở nên khá hơn (kém hơn)
get into : vào, bắt đầu( cãi nhau, đánh nhau), dấn thân vào
get into difficulties : gặp khó khăn, trở ngại
get lost : đi lạc
get married : lấy ai
get off : xuống xe, xuống bến
get on : lên xe, đón xe bus
get on one's nerves : làm cho ai bực mình, tức giận, khó chịu
get out of doing s.th : tránh khỏi phải làm điều gì
get over : vượt qua, phục hồi, lấy lại
get rid of : đuổi đi, loại trừ, vất đi
get through : xong, làm xong, xong việc
get to (a place) : tới, đến nơi
get up : thức dậy
get used to : trở nên quen với, làm quen với
give advice to s.o : khuyên bảo ai
give birth to : sinh, đẻ ra
give into s.o : nhượng bộ ai
give s.o s.th : cho ai cái gì
give s.th away : cho cái gì đi làm quà tặng
give up : đầu hàng, từ bỏ, chối bỏ
go for a walk : bách bộ, dạo bộ
go for( on) a picnic : mời đi…
go in for : chơi ham mê
go in for : hâm mộ
go through: kiểm soát, xem xét
go up to : đi tới
go with : xứng hợp với (đúng mốt)
go without : nhịn, chịu thiếu thốn
go wrong : hư hỏng, trục trặc, ,không lành.
hang on to s.th : nắm chặt cái gì
hang up : treo, móc, nhấc lên
have a craving for s.th : thèm khát điều gì
have a demand for : có nhu cầu về
have a dexterity in doing s.th : khéo làm việc gì
have on : mặc, bận, đội, mang
have s.th in one's hand : tay cầm vật gì
have time off : có thời gian rảnh, nghỉ việc ở không
hear of : nghe nói tới
hit below the belt : đánh dưới thắt lưng
hold good : giữ hiệu lực, giá trị, duy trì
hold s.th to the fire : hơ cái gì vào lửa
hold still : ngồi yên, đứn yên, giữ yên
hold up : chặn cướp, cướp, hoãn lại, trở ngại, bế tắc
hope for s.th : hi vọng điều gì
introduce s.o to another : giới thiệu ai với một người khác
judge s.o by one's appearance : xét người nào về bề ngoài.
jump over s.th : nhảy qua vật gì
keep away from : tránh xa khỏi
keep good time : chạy chính xác, chạy đúng giờ (đồng hồ)
keep house : làm việc nhà, làm nội trợ
keep in touch with : liên lạc, giao thiệp
keep on : tiếp tục
keep on doing s.th : tiếp tục làm việc gì
keep out, off, away, from... : tránh ra xa, ở ngoài...
keep track of : theo dõi, ghi nhớ
keep up : giữ ở một mức, cấp độ
keep up with s.o : bắt kịp ai
knock out : đánh bại, đánh ngất, làm bất tỉnh
know all about s.th : biết toàn bộ về điều gì
know s.o by sight : biết mặt ai, có nhìn thấy
know s.o from s.o : phân biệt ai với ai
laugh at : cười chế nhạo
lean on : tựa lên, dựa lên
learn s.th by heart : học thuộc lòng
leave out : thiếu sót, bỏ sót, làm mất
leave s.th with s.o : để cái gì lại cho ai giữ
let go of s.th : buông cái gì ra
let on : tiết lộ, bộc bạch ra, cho hết
lie down : tựa vào vật gì, nằm xuống
live from hand to mouth : sống tay làm hàm nhai, kiếm được đồng nào xào đồng đấy
live on : sống nhờ vào
live up to : đạt được, giữ được
live within one's income : sống theo hoàn cảnh, sống theo thu nhập của mình
live within one's means : sống trong điều kiện cho phép
long for : mong đợi
look after : take care of : chăm nom, chăm sóc
look at : nhìn vào, trông vào
look down upon : khinh khi , khinh thị , khinh dễ
look for : tìm kiếm
look into: tra xét cẩn thận, điều tra kỹ lưỡng
look on with s.o : xem nhờ ai
look out : coi chừng cẩn thận
look over : xem xét ,phán đoán, duyệt lại, xem lại
look to s.o for help : trông cậy ai giúp đỡ
look up : tìm kiếm , tra từ điển
look up to: kính trọng, kính mến
make a success of s.th : thành công về cái gì
make believe : giả vờ, giả đò
make clear : vạch rõ, giảng, nói rõ
make faces : nhăn nhó, nhăn mặt, làm trò khỉ
make for the open sea : bắt đầu ra khơi
make friend : kết bạn, làm bạn
make good : thành công (thêm giới từ in)
make good time : đi nhanh chóng, mau
make oneself pleasant to s.o : vui vẻ chiều chuộng, làm hài lòng ai
make out :
make out : thành công, tiến bộ, có kết quả
make over : sửa đổi trang phục lại cho giống như mới
make sense : có thể tin được, có lý, hợp lý
make up :
make up one's mind : quyết định
meet halfway : điều đình, hóa giải.
meet s.o at (a place) : đón ai ở một nơi nào
moan like hell : than trời trách đất
object to : phản đối
object to s.th : phản đối điều gì
pay s.th for s.th : trả vật gì để được cái gì
pick up : chọn lựa
pick up : nhấc lên, cầm lên
pin the failure on s.o : đổ thừa thất bại là do ai
plan on doing s.th : dự định làm điều gì
point out : chỉ, vạch ra
prevent s.o from doing s.th : ngăn cản ai làm điều gì
protect s.o from s.th : che chở cho ai khỏi điều gì
provide s.o with s.th : cung cấp cho ai cái gì
put credit in s.o : đặt tin tưởng vào ai
put down : đàn áp, dẹp, tiễu trừ
put on (weight ) : cân nặng thêm, béo ra, lên cân
put on : mặc, đội, mang ( mũ, nón, áo quần...)
put out : dập tắt, thổi tắt (ngọn lửa, đèn)
put s.th away : cất vật gì vào chỗ của nó
put together : lắp, rắp lại, hợp lại với nhau
put up with : chịu đựng
put up with : chịu đựng, nhân nhượng
quarrel about s.th : cãi nhau vì chuyện gì
quarrel with s.o about s.th : cái nhau với ai về điều gì
read s.th in the book : đọc được điều gì đó trong sách
rejoice at (over, in) s.th : mừng rỡ về điều gì
rely on : tin tưởng vào ai
reminds s.o of s.th : gợi ai nhớ điều gì
respect s.o for s.th : kính trọng ai về điều gì
rest s.th against s.th : tựa, đấu cái gì vào cái gì
run across : to come across : tình cờ gặp, chạm trán với, ngẫu nhiên thấy
run across s.o : tình cờ gặp lại ai
run an errands : làm việc vặt, mua bán lặt vặt
run away : thoát ly, ra đi, trốn đi
run away from home : bỏ nhà ra đi, trốn khỏi nhà
run into : tình cờ gặp, chạm trán với, ngẫu nhiên thấy
run up to : chạy tới
rush at s.o : xông vào ai
sacrifice one's life : hi sinh cuộc đời mình cho
save s.o from doing s.th : giúp ai tránh khỏi phải làm điều gì
say s.th to s.o's face : nói thẳng vào mặt ai
see about : để ý đến, lưu ý, lưu tâm
see s.o off at (a place) : tiễn ai
serve one right : đáng tội, đáng kiếp, đáng đời.
set fire to : làm cháy, tiêu hủy
set on fire: đốt cháy
set out : bắt đầu, ra đi, lên đường, khởi hành
shake hand : bắt tay chào
show a spirit towards s.o : chứng tỏ tình cảm, chứng tỏ tinh thần đối với ai
show off : khoe khoang, phô trương
show up : hiện diện, có mặt
smile at s.o : mỉm cười với ai
speak in whisper : nói nhỏ, nói thì thầm
spend money on s.th : tiêu tiền vào việc gì
stand a chance : có cơ hội, có thể có được
stand for : khoan dung ,chiu đựng
stand for : tượng trưng cho, thay thế cho
stand out : nổi bật
stand to reason : rõ ràng, hợp lí, cố ý, hiển nhiên
stand up for : đòi hỏi, bênh vực, ủng hộ.
stay in : ở nhà
stay out : vắng nhà, đi ra ngoài
stay up : ngồi thức , thức
stick s.o : lừa gạt, lừa đảo.
stick to : kiên trì đeo đuổi, bền lòng, không thay đổi.
stick up : cướp có vũ khí
suffer from : khổ vì, đau khổ vì
suggest to s.o : gợi ý cho ai, cho ai biết là
supply s.o with s.th : cung cấp cho ai cái gì
take s.o for s.o : nhầm ai với ai
take a look at : xem, nhìn đến
take a seat : ngồi xuống , mời ngồi.
take a walk : đi bộ, đi dạo
take apart : thào rời từng bộ phận
take delight in doing s.th : thích thú làm điều gì
take down : lấy xuống, đem xuống, ghi chép ( tốc ký )
take for granted : xem cho là thật, là hiển nhiên, chấp nhận như vậy
take hold of : cầm, nắm lấy
take into account : để ý đến, kể đến, lưu ý đến
take off : cởi, tháo, gió ( nón, dày, dép...)
take on : tuyển dụng, thuê mướn ( người làm)
take one's time : làm thư thả , không vội vàng, làm một cách ung dung
take one's word for s.th : tin tưởng lời ai nói về điều gì
take over : đảm đương, đảm nhiệm, đảm trách
take pains : làm việc tận lực, hết sức cẩn thận
take part : tham dự
take pity on : thương hại, thương xót
take place : xảy ra
take s.o by surprise : làm cho ai ngạc nhiên
take s.o by the hand : nắm tay ai
take s.o by the hand : nắm tay ai
take time off to have time off : được nghỉ, nghỉ
talk over : bàn luận, thảo luận, nghiên cứu, xem xét
taste of : có mùi, có vị
tear off : xé đứt, xé bỏ
tear up : xé ra thành từng mảnh, hủy bỏ
tell s.o about s.th : kể cho ai nghe về điều gì
thank s.o for doing s.th : cảm ơn ai vì đã làm điều gì
think of : nghĩ tới, có ý kiến về
think of s.o : nghĩ về ai
think over : suy nghĩ chính chắn, xét kỹ
think up : phát minh, khám phá, tìm ra
throw s.th at s.o : ném cái gì vào ai
tie up : cột chặt, buộc chặt
treat someone to something : thiết đãi ai món gì
tremble with cold : run vì lạnh
trouble s.o for s.th : phiền ai giúp điều gì
try on : thử, cố gắng
turn into : đổi sang, đổi thành
turn on : mở, bật ( TV, máy lạnh , đèn...) trái ngược với to turn off
turn one's back on s.o : quay lưng lại với ai, bỏ rơi ai
turn out : hóa ra, rốt cuộc, trở thành
wait on / upon : dọn bàn ăn (chỗ người nào đó) phục dịch
walk up to : tiến tới
waste time on s.th : lãng phí thời gian về việc gì
waste time on s.th : phí phạm thời gian về việc gì
wish for : ước ao
wonder about : tự hỏi về, ngạc nhiên về
work for a company : làm việc cho một công ty
work for living : làm việc để kiếm sống
worry about : lo lắng về